20 20;
2 2 2 2 2 2 2 2 2 2 2 2 2 2 2 2 2 2 2 2 ;
2 2 2 2 2 2 2 2 2 2 2 2 0 0 0 0 0 0 0 2 ;
2 2 2 2 2 2 2 2 2 2 2 0 0 0 0 0 0 0 0 2 ;
2 2 2 2 2 2 2 2 2 2 0 0 0 0 0 0 0 0 0 2 ;
2 2 2 2 2 2 2 2 2 0 0 0 0 16 17 17 17 18 0 2 ;
2 2 2 2 2 2 2 2 0 0 0 0 16 2 2 2 2 34 0 2 ;
2 2 2 2 2 2 2 0 0 0 0 16 2 2 2 2 2 34 0 2 ;
2 0 0 0 0 0 0 0 0 0 16 2 2 2 2 2 2 34 0 2 ;
2 0 0 0 0 0 0 0 0 16 2 2 2 2 2 2 2 34 0 2 ;
2 0 0 0 0 0 0 0 16 2 2 2 2 2 2 2 2 34 0 2 ;
2 17 17 17 17 17 17 17 2 2 2 2 2 2 2 2 2 34 0 2 ;
2 2 2 2 2 2 2 2 2 2 2 2 2 2 2 2 2 34 0 2 ;
2 2 2 2 2 2 2 2 2 2 2 2 2 2 2 2 2 34 0 2 ;
2 49 49 49 49 49 49 49 49 49 49 49 49 49 49 49 49 50 0 2 ;
2 0 0 0 0 0 0 0 0 0 0 0 0 0 0 0 0 0 0 2 ;
2 0 0 0 0 0 0 0 0 0 0 0 0 0 0 0 0 0 0 2 ;
2 0 0 0 0 0 0 0 0 0 0 0 0 0 0 0 0 0 0 2 ;
2 17 17 17 17 17 17 17 17 17 17 17 17 17 17 17 17 17 17 2 ;
2 2 2 2 2 2 2 2 2 2 2 2 2 2 2 2 2 2 2 2 ;
2 2 2 2 2 2 2 2 2 2 2 2 2 2 2 2 2 2 2 2 ;
